osteoarthritis	['symptom', 'treatment', 'cause', 'diagnosis', 'diet']
liberty mississippi	['zip code', 'home for sale', 'population']
alpers disease	['diagnosis', 'treatment', 'research', 'research', 'symptom']
visceral larva migrans	['medication', 'overview', 'follow-up', 'presentation']
the gruffalo film	['cast', 'dvd', 'trailer']
silver star motors	['local map', 'shops photo', 'services', 'business information']
cloacal exstrophy	['symptoms', 'living with', 'related diseases']
hefner grill	['starters', 'greens', 'sides', 'desserts']
mount carmel illinois	['zip code', 'news', 'what time is it', 'population']
eielson air force base	['weather', 'job', 'zip code']
screaming trees	['song', 'albums', 'singer', 'singer', 'tour']
fig olive	['appetizer', 'salad', 'panini burger', 'panini burger', 'pasta risotto']
palembang	['etymology', 'history', 'administration', 'geography', 'demography']
marine exchange	['shops photo', 'local map', 'services', 'business information']
almost, maine	['character', 'summary', 'review']
withington	['governance', 'demography', 'demography', 'economy', 'geography']
night terrors in toddlers	['cause', 'treatment']
wegener's disease	['symptom', 'treatment', 'cause', 'diagnosis', 'diet']
jp automotive	['shops photo', 'local map', 'jp automotive hour', 'service', 'business information']
dog fashion disco	['dog fashion disco discography', 'lyrics', 'tour']
balabac palawan	['history', 'demographics', 'transportation']
sleep band	['sleep band tour', 'sleep band merch', 'sleep band metallum']
dialysis disequilibrium syndrome	['cause', 'treatment']
hyde county north carolina	['job', 'news', 'population']
livermore audi	['shops photo', 'local map', 'service', 'business information']
canalith repositioning maneuvers	['overview', 'contraindication', 'rationale']
haiphong	['geography', 'history', 'administrative division', 'economy', 'demographics']
nirvana restaurant	['most popular', 'soup', 'salads', 'rice']
brenner pass	['map', 'history', 'restaurant']
sumpter township michigan	['homes for sale', 'news', 'zip code']
selbyville delaware	['zip code', 'homes for sale', 'selbyville']
i am alive	['review', 'ending', 'cheat', 'gameplay']
frugals	['burgers sandwich', 'soda', 'milk shake']
fuel pizza	['lubricant', 'starter', 'fresh salad', 'buffalo wing', 'specialty chicken pizza']
johnson county texas	['job', 'news', 'population']
omera	['interaction', 'overdose', 'precaution', 'side effect', 'use']
wellington texas	['zip code', 'home for sale', 'hotel', 'population']
zoon's balanitis	['cause', 'treatment']
cypress hill	['song', 'member', 'tour', 'merch']
suzuki boulevard c50	['engine', 'key feature', 'additional feature']
digital rectal examination	['overview', 'technique', 'periprocedural care']
viaggio	['dinner antipasta', 'dinner insalata', 'dinner paste', 'dinner pollo', 'dinner pesce']
baltimore ohio	['zip code', 'homes for sale', 'population', 'news']
advanced healing ointment	['interaction', 'overdose', 'precaution', 'side effect', 'use']
new york botanical garden	['event', 'parking', 'job']
ollier disease	['cause', 'diagnosis', 'living with', 'prognosis', 'symptom']
prescription medications	['getting prescriptions filled', 'making sense of abbreviation', 'preparing for a doctor appointment', 'generic', 'at the doctor office']
bergeys ford	['shops photo', 'local map', 'service', 'business information']
east coast cycle center	['shops photo', 'local map', 'service', 'business information']
nokia asha 201	['battery', 'design', 'display', 'camera', 'hardware']
rangely colorado	['weather', 'population', 'zip code', 'homes for sale']
milngavie	['history', 'landmark', 'education', 'governance', 'places of worship']
wash n roll	['business information', 'shop photo', 'local map', 'service']
albion online	['review', 'gameplay', 'release date']
finger infection	['exam and test', 'when to seek medical care', 'cause', 'overview']
oxford maine	['zip code', 'history', 'weather']
akatsuki no yona	['manga', 'character', 'song']
winter park resort	['map', 'picture', 'job']
ameri gas	['shop photo', 'local map', 'service', 'business information']
eight men out	['cast', 'summary', 'quote', 'blu ray', 'trailer']
bryn terfel	['biography', 'discography', 'honour', 'faenol festival']
mungo park	['early life', 'second journey', 'work', 'legacy']
sparkling image car wash	['local map', 'hour', 'service', 'business information']
mendota california	['weather', 'news', 'zip code', 'population']
muir-torre syndrome	['differential diagnosis', 'medication', 'overview', 'treatment']
bread basket deli	['soup', 'premium salad', 'plate', 'sandwich']
bmw of anchorage	['local map', 'bmw of anchorage hours', 'business information']
microcephaly	['diagnosis', 'treatment', 'symptom', 'diagnosis', 'diet']
cafe murano	['breakfast sandwich', 'salad', 'espresso drink']
kamen rider gaim	['cast', 'character', 'theme song']
triple x syndrome	['symptom', 'treatment', 'cause', 'diagnosis', 'diet']
south sioux city nebraska	['zip code', 'weather', 'population']
clavus	['medication', 'differential diagnosis', 'treatment', 'overview', 'presentation']
grupo niche	['video', 'concert', 'lyric', 'discography']
westbury nissan	['shops photo', 'local map', 'business information']
corregidor island	['tour', 'map', 'history']
trotwood ohio	['zip code', 'map', 'news', 'history']
papillary necrosis	['overview', 'treatment', 'workup']
prime motors	['shops photo', 'local map', 'services', 'business information']
ford fiesta van	['practical', 'low cost of ownership', 'safe']
as told by ginger	['episode', 'theme song', 'cast', 'character']
west nile encephalitis	['differential diagnosis', 'overview', 'presentation', 'treatment']
right ventricular conduction delay	['causes', 'treatment']
supernoobs	['character', 'episode', 'rating', 'plot', 'broadcast']
sickle cell anemia	['symptom', 'cause', 'treatment', 'diagnosis', 'diet']
acitretin	['side effect', 'cost', 'prescribing information', 'brand name', 'generic']
leiden	['thing to do', 'what time is it', 'weather', 'zip code']
quiet riot	['song', 'member', 'album', 'tour']
diabetes diet	['type 1', 'type 2']
guinea pig	['care for', 'bathe', 'train', 'breed', 'play with']
croton plant	['outdoor', 'indoor']
agario	['ios', 'android']
lipoma	['treatment', 'symptom', 'cause', 'diagnosis', 'diet']
haloperidol	['side effect', 'half life', 'dosage', 'generic', 'injection']
office 365	['use', 'install', 'remove']
koi fish	['for sale', 'pictures', 'fact', 'type', 'eat']
psycho	['cast', 'characters', 'summary', 'trailer', 'quotes']
cursive	['letters', 'notepad', 'cards', 'stickers', 'magnets']
life	['succeed', 'enjoy', 'play', 'live', 'change']
protein	['get', 'test', 'calculate', 'make', 'isolate']
nebraska	['abbreviation', 'time', 'population', 'job', 'unemployment']
gettysburg	['movie', 'college', 'address', 'city', 'national military park']
trailer	['build', 'load', 'back up', 'wire', 'level']
donkey	['picture', 'fact', 'baby', 'sound']
crystal city	['hotel', 'zip code', 'restaurant', 'thing to do', 'population']
pad thai	['shrimp', 'tofu', 'chicken', 'vegetable', 'cabbage']
bleach	['use', 'watch', 'make', 'dispose', 'dilute']
chuck	['tv show', 'berry', 'norris', 'meat', 'film']
pantera	['song', 'album', 'member', 'merch', 'lyric']
paper	['make', 'use tracing', 'grade', 'laminate', 'recycle']
santa barbara	['population', 'things to do', 'fact', 'hotel', 'weather in may']
facial tingling	['left side', 'right side']
martinique	['things to do', 'flag', 'currency', 'population', 'time']
cuadra	['boots', 'belt', 'wallet', 'messenger bag', 'jacket']
dermatophytosis	['treatment', 'symptom', 'cause', 'diagnosis', 'diet']
front loading washing machine	['maytag', 'kenmore', 'samsung', 'lg', 'ge']
velvet revolver	['member', 'album', 'lyric', 'tour']
onekey optimizer	['windows 10', 'windows 7']
geckodriver	['firefox', 'chrome']
tukui client	['for windows', 'for mac', 'for linux']
tamarillo	['fruit', 'seed']
minarik	['guitar', 'bass']
polar fleece	['sock', 'pant', 'jacket', 'blanket', 'hat']
motilal oswal	['financial service', 'asset management', 'private equity']
hieroglyphics	['for kid', 'animal']
agris	['software', 'system']
chlamydia	['fact', 'life cycle', 'type']
lost	['jack shephard', 'sayid jarrah', 'charlie pace', 'john locke', 'kate austen']
vista, ca	['weather', 'zip code', 'population', 'homes for sale']
suva beauty	['eyeshadow', 'eyeliner']
new caledonia	['time', 'population', 'flag', 'news']
hydrocodon	['side effect', 'warning', 'half life', 'interaction']
cephalexin	['side effect', 'brand name', 'generic']
kitchenaid dishwasher	['reset', 'install']
cold	['cure', 'prevent', 'dress']
std	['protect against', 'get']
netjets	['career', 'headquarter', 'stock']
vests for men	['sheepskin', 'down', 'fleece', 'wool', 'denim']
internet explorer	['windows 10', 'windows 7', 'windows 8', 'windows xp']
volcanic eruption	['prepare for', 'survive']
royal farms arena	['event', 'parking', 'map']
gta game download	['windows 7', 'windows 10', 'windows 8', 'windows vista']
how to get rid of bruises fast	['face', 'leg', 'arm']
nike boys shoes	['running', 'basketball', 'soccer', 'tennis', 'golf']
ikea furniture	['office', 'bedroom', 'kitchen', 'living room', 'dining room']
matera italy	['hotel', 'restaurant']
star wars mod	['minecraft', 'prison architect', 'stellaris', 'terraria', 'starbound']
loch ness	['fact', 'map', 'photo', 'tour']
moxifloxacin	['eye drop', 'side effect', 'generic', 'brand name', 'hydrochloride']
how do you add a border in word	['word 2013', 'word 2010', 'word 2016']
bass guitar	['for sale', 'type', 'history', 'picture']
fanny pack	['men', 'women', 'girl']
bape	['hoodies', 'backpack', 'clothing', 'pant', 'shirt']
lose weight	['food', 'exercise', 'synonym']
weight loss	['apple cider vinegar drink recipe', 'yoga']
girls birthday party	['idea', 'place', 'game', 'tutu', 'invitation']
income tax	['provision', 'accounting', 'deduction', 'how to file']
wedding day	['makeup', 'inspirational quote', 'checklist']
carrot	['nutrition', 'benefit', 'seed']
chloroxazone	['brand name', 'side effect', 'generic', 'dosage']
express vpn	['windows', 'mac', 'ios', 'blackberry', 'linux']
naruto the last	['soundtrack', 'dub']
persuasive speech	['write', 'end']
the harlem renaissance	['music', 'literature', 'culture', 'religion']
orthomolecular medicine	['depression', 'alcoholism', 'bipolar', 'diabete', 'schizophrenia']
vsi	['visual storage intelligence', 'vinyl siding institute']
tsa precheck	['get', 'use']
apple cider vinegar	['drink', 'make']
low ph	['in pool', 'in hot tub']
2018 calendar printable free	['pdf', 'word', 'excel']
google chrome exe	['64 bit', '32 bit']
five nights at freddy's 2	['trailer', 'cheat', 'release date']
realplayer	['windows 10', 'windows 7', 'windows 8', 'windows xp', 'windows vista']
painting frames	['oil', 'canvas', 'acrylic', 'chalk']
lego sets	['minecraft', 'star war', 'marvel', 'harry potter', 'batman']
buy laptop online	['acer', 'hp', 'toshiba', 'apple', 'dell']
directions google maps	['driving', 'walking', 'bus', 'transit', 'biking']
the good doctor	['cancelled', 'cast', 'episode']
kelowna	['things to do', 'weather', 'population', 'what time is it']
radio	['listen to', 'stream', 'use', 'talk on', 'remove']
the lost horizon	['book', 'film', 'dvd']
office 365	['use', 'install', 'remove']
root beer	['history', 'soda', 'candy']
okoye marvel	['comic', 'legend']
hemp cbd	['oil', 'cream', 'food', 'tea', 'seed']
palestine	['map', 'history', 'capital', 'population']
maryland	['abbreviation', 'time', 'job', 'flag', 'unemployment']
apache	['install', 'use', 'restart']
zombies	['play', 'make', 'beat', 'spawn']
arrow puller	['excalibur', 'tenpoint']
greece	['thing to do', 'time', 'news', 'currency', 'flag']
wisteria	['grow', 'prune', 'winterize']
vampire	['specie', 'diary']
mars	['live on', 'see', 'get to']
coal	['type', 'picture']
hellblade	['trailer', 'review', 'gameplay']
winter	['dress', 'survive', 'enjoy', 'rv']
project management	['how to use jira', 'planning tool', 'onenote']
fast weight loss	['best diet', 'food', 'tip']
pest control	['peppermint plant', 'marigold flower', 'power sprayer']
fence install	['survey', 'code', 'average labor cost', 'handyman']
teamviewer 12	['download', 'update']
whale	['picture', 'fact', 'specie', 'sound', 'eat']
meat boy	['newground', 'kongregate', 'armor game']
wallpapers	['change', 'remove', 'paint over']
uber	['use', 'contact', 'drive for']
maned wolf	['picture', 'as pet', 'fact', 'scientific name', 'reproduction']
poison oak	['identify', 'treat']
lynch syndrome	['symptom', 'treatment', 'diagnosis', 'cause', 'diet']
mdot michigan	['construction', 'traffic', 'aviation', 'real estate', 'business']
azathioprine	['side effect', 'brand name', 'cost', 'mechanism of action', 'generic']
loomis insurance	['health', 'dental', 'vision']
outlook email	['use', 'set up', 'save', 'organize']
cover letter	['write', 'start', 'address']
cotton boll	['wreath', 'christmas ornament', 'christmas tree']
saskatoon	['thing to do', 'weather', 'population', 'what time is it', 'zip code']
walkout basement	['house', 'patio', 'garage', 'with pool']
astyle	['windows', 'linux', 'python']
kitsapgov	['auditor', 'clerk', 'sheriff']
spongebob squarepants	['cast', 'song', 'quote', 'summary']
monkey grass	['type', 'how to care', 'fact']
indian	['spinach', 'potato', 'cheese', 'butter', 'vegetable']
chevy silverado 2018	['accessory 2018', 'spec 2018']
doxazosin	['side effect', 'mechanism of action', 'half life']
sclerosing mesenteritis	['pathology', 'gastroenterology', 'surgery', 'radiology']
sxm radio	['nfl', 'mlb', 'college football']
cuadra	['boot', 'belt', 'wallet', 'messenger bag', 'jacket']
the story of job	['kjv', 'niv']
can't sign into microsoft account	['windows 10', 'windows 8', 'windows 7', 'windows vista']
arslan	['character', 'episode']
aussie bites costco	['calory', 'ingredient']
used snow plows for sale	['craigslist', 'ebay']
lynley mysteries	['book', 'movie']
tamil hd movies free download	['1080p', '720p']
1password windows	['windows 10', 'windows 8', 'windows 7', 'windows vista']
is my pc 32 or 64-bit	['windows 10', 'windows 8', 'windows 7', 'windows vista']
kino's storytime	['dvd', 'vhs']
old disney channel shows	['1990s', '2000s']
iphone hotspot not working	['windows 10', 'windows 8', 'windows 7', 'windows vista']
enable java in internet explorer	['internet explorer 11', 'internet explorer 10']
sony srs x55	['driver', 'manual']
napoleon municipal court	['clerk', 'prosecutor']
leica ts16	['leica ts16 manual', 'leica ts16 specifications']
fantasy football start em sit em	['qb', 'wr']
99 bananas	['calories', 'ingredients']
wolverine and the x-men	['characters', 'episodes']
romans 2 12	['esv', 'kjv', 'niv']
ephesians 6-16	['esv', 'kjv', 'niv', 'nlt']
dance with the teletubbies	['dvd', 'vhs']
babo baby	['shampoo', 'soap']
system using 100% disk	['windows 10', 'windows 8', 'windows 7', 'windows vista']
stellar kart	['stellar kart lyrics', 'stellar kart chords']
rocky river court	['forms', 'reports']
how to collapse rows in excel	['excel 2016', 'excel 2013', 'excel 2010']
eating disorder clinic	['ucla', 'ucsd']
morrow county municipal court	['morrow county municipal court clerk', 'prosecutor']
dr ball	['chiropractor', 'dermatologist', 'orthodontist']
word background	['image', 'word background text']
power user	['windows 10', 'windows 7', 'windows server 2012']
afterbuzz tv	['empire', 'scandal', 'scandal', 'scorpion', 'supernatural']
genesis 12-1	['esv', 'kjv', 'niv', 'nlt']
edwards electric	['construction', 'telecom']
how to self publish	['novel', 'poetry', 'short stories']
dcm speakers	['craigslist', 'ebay']
how to save to desktop	['windows 10', 'windows 7', 'windows 8', 'windows vista']
veggietales sumo of the opera	['vhs', 'dvd']
enable developer tab in excel	['excel 2016', 'excel 2013', 'excel 2010', 'excel 2007']
dog bar	['shampoo', 'soap']
mott's fruit snacks	['calories', 'ingredients']
cpac army	['fort bliss', 'fort hood']
genesis 9-3	['esv', 'kjv', 'niv']
toaru kagaku no railgun	['characters', 'episodes']
mickey's great clubhouse hunt	['dvd', 'vhs']
config sys	['windows 10', 'windows 8', 'windows 7']
ford futura	['convertible', 'wagon']
chkdsk r	['windows 10', 'windows 8', 'windows 7']
last dinosaurs	['chords', 'lyrics', 'ukulele tab']
how to create a timeline in excel	['excel 2013', 'how to create a timeline in excel 2016']
c++ redistributable 2013	['x64', 'x86']
1921 yankees	['roster', 'stats']
screenshotting on windows	['windows 10', 'windows 8', 'windows 7', 'windows vista']
trim function in excel	['excel 2010', 'excel 2013', 'excel 2016']
photo effects	['photoshop', 'powerpoint', 'word']
society of the cincinnati	['flag', 'motto']
lee child's	['novels', 'short stories']
clear cookies in internet explorer	['internet explorer 10', 'internet explorer 11']
credit card chargeback	['accounting', 'laws']
diaphragm wall	['construction', 'design']
steven universe cartoon network	['characters', 'episodes']
hershey's syrup	['calories', 'ingredients']
visual c++ 2015 redistributable	['x64', 'x86']
microsoft visual c++ 2005 redistributable	['x32', 'x64', 'x86']
outlook 2016 won't open	['windows 10', 'windows 8', 'windows 7', 'windows vista']
financial aid login	['uci', 'ucsb']
the haunted hathaways	['characters', 'episodes']
mercedes c class	['hatchback', 'sedan']
j3 2016	['firmware', 'manual']
garden city community college football	['roster', 'stats']
sanitation nyc	['sanitation nyc salary', 'sanitation nyc job description']
supplier code of conduct	['oracle', 'unilever']
west wight potter	['manual', 'specifications']
car wallpapers	['4k', '1080p', 'hd']
honey boba	['calory', 'ingredient']
cell references in excel	['excel 2016', 'excel 2010', 'excel 2013']
cpps certification	['practice test', 'study guide']
how to delete amazon prime	['books', 'movies']
cet certification	['practice test', 'study guide']
2f	['javascript', 'python']
access database on sharepoint	['sharepoint 2010', 'sharepoint 2013']
perfmon report	['windows 10', 'windows 8', 'windows 7', 'windows vista']
mail merge from excel	['excel 2010', 'excel 2016', 'excel 2013']
filehippo firefox	['32 bit', '64 bit']
albumin high	['blood', 'csf']
kentucky wildcat football	['roster', 'stats']
pontiac tempest	['convertible', 'station wagon']
raptors 905	['roster', 'stats']
100 ways	['100 ways chords', '100 ways lyrics']
venn diagram generator	['excel', 'word']
veer zaara movie download	['720p', 'hd']
latest malayalam songs	['mp3', 'mp4']
amity region 5	['high school', 'middle school']
1969 barracuda	['craigslist', 'ebay']
yahoo email settings	['imap', 'pop3']
french wars	['1600s', '1700s', 'french wars 1800s']
ngugi wa thiong'o	['novel', 'short story']
disable windows defender	['windows 10', 'windows 8', 'windows 7', 'windows vista']
soul contract	['characters', 'episodes']
dell latitude 7480 drivers	['windows 10', 'windows 8', 'windows vista', 'windows 7']
1952 chevy	['1952 chevy coupe', 'truck', 'station wagon']
hi mark	['construction', 'landscaping', 'realty']
walkman mp3 player	['driver', 'manual']
hardware wars	['dvd', 'vhs']
production sheet	['bakery', 'restaurant']
how to use groove music	['android', 'iphone']
rock n learn letter sounds	['dvd', 'vhs']
edge of the universe	['lyric', 'chord']
where to find my ip address	['windows 10', 'windows 7', 'windows 8', 'windows vista']
empty apartment	['chord', 'lyric']
what is vlookup in excel	['excel 2010', 'excel 2016', 'excel 2013']
if the creek don't rise	['chord', 'lyric']
colossians 3-5	['esv', 'kjv', 'niv', 'nlt']
lotus cortina	['craigslist', 'ebay']
seacraft boats for sale	['craigslist', 'ebay']
dora pirate adventure	['dora pirate adventure dvd', 'dora pirate adventure vhs']
google chrome download pc	['windows 10', 'windows 8', 'windows 7', 'windows vista']
free powerpoint themes	['science', 'music']
star versus the forces of evil	['episodes', 'characters']
the citizens	['the citizens state bank', 'the citizens national bank']
minecraft skins undertale	['papyrus', 'sans']
johns hopkins baseball	['roster', 'stats']
chevy blazer for sale	['craigslist', 'ebay']
ncis wikipedia	['ncis wikipedia characters', 'ncis wikipedia episodes']
dd 3.5 character sheet	['excel', 'pdf', 'word']
land of the lost tv show	['characters', 'episodes']
how to create fillable forms in word	['word 2016', 'word 2010', 'word 2013']
1980 houston astros	['roster', 'stats']
la muerte	['comic', 'graphic novel']
itunes won't open	['windows 10', 'windows 8', 'windows 7', 'windows vista', 'vista']
google chrome exe	['64 bit', '32 bit']
transfer pictures	['android', 'iphone']
centimeters	['inch', 'millimeter', 'feet', 'meter', 'kilometer']
prom dresses	['long', 'short']
underwear for women	['jockey', 'hanes', 'calvin klein', 'fruit of the loom', 'tommy hilfiger']
outlook email setup	['imap', 'pop3']
what does npi stand for	['dental', 'medical']
cute easy hairstyles	['medium', 'long', 'short']
active transport definition biology	['secondary', 'primary']
aikido techniques	['beginner', 'advanced']
how long to cook liver	['lamb', 'beef', 'pork', 'chicken', 'turkey']
dell t5400	['motherboard', 'memory', 'power supply', 'processor', 'video card']
conexant audio driver windows 10	['hp', 'asus', 'dell', 'toshiba', 'lenovo']
vein stenosis	['hepatic', 'renal', 'pulmonary']
mini scones	['vanilla bean', 'chocolate chip', 'lemon', 'cinnamon', 'pumpkin']
dump cakes	['apple', 'cherry', 'chocolate', 'pumpkin', 'lemon']
spring valley sales	['boat', 'car']
wall mounted toothbrush holder	['ceramic', 'wood', 'chrome', 'bronze', 'plastic']
hazard lights	['tractor', 'car', 'bus']
causes for gout	['toe', 'elbow', 'finger']
fireplace accessories	['gas', 'wood', 'electric', 'propane']
wire rack	['shelving', 'wire rack cart']
vob player	['windows', 'mac', 'android']
southern farm bureau	['insurance', 'bank']
docker volumes	['postgres', 'mysql']
hits from 1979	['dance', 'pop', 'rock']
yt converter	['mp3', 'mp4']
clone watches	['breitling', 'omega', 'rolex', 'panerai', 'cartier']
news jerusalem	['fox', 'cnn', 'abc', 'bbc', 'nbc']
watches	['tag heuer', 'citizen', 'omega', 'fossil', 'cartier']
quotes and sayings	['alcohol', 'age', 'love', 'life', 'inspirational']
man vs wild	['photo', 'video', 'episode', 'news']
calenders	['desk', 'wall', 'pocket', 'travel', 'art']
create email address now	['yahoo', 'msn', 'hotmail', 'gmail', 'aol']
direct buy login	['cabinet', 'entertainment', 'book', 'jewelry', 'flooring']
watch movies online net free	['megamind', 'unstoppable', 'skyline', 'due date', 'easy a']
watch movies online net free	['crime', 'comedy', 'adventure', 'drama', 'horror']
watch movies online net free	['supernovatube', 'myspace', 'tudou', 'veoh', 'dailymotion']
kscfcu	['banking', 'loan', 'credit union', 'mortgage']
21 weeks pregnant	['second trimester', 'first trimeter', 'third trimester']
birkenstocks	['orthotics', 'fit flops', 'newalk', 'alegria', 'teva']
squinkies	['spongebob', 'disney', 'star war', 'marvel', 'toy story']
