onekey optimizer	['windows 10', 'windows 7']	which system are you looking for?
nsw tafe portal	['staff', 'student']	which student are you looking for?
spring valley sales	['boat', 'car']	which vehicle are you looking for?
alex and ani bracelets	['for mom', 'for women', 'for girls', 'for baby']	what do you want to know about this occasion or no occasion?
eastlake	['middle school', 'elementary school']	what do you want to know about this style?
wall mounted toothbrush holder	['ceramic', 'wood', 'chrome', 'bronze', 'plastic']	which material are you looking for?
network shared folder	['windows 10', 'windows 7']	which windows are you looking for?
geckodriver	['firefox', 'chrome']	which browser are you looking for?
my town game	['hospital', 'airport', 'school', 'museum', 'wedding game']	what do you want to know about this character?
adobe edit pdf	['to word', 'to excel', 'to linux', 'to outlook']	what do you want to know about adobe edit pdf?
teveten	['discontinued', 'side effect']	what do you want to know about this high blood pressure?
battle of poitiers	['tour', 'fact']	what do you want to know about battle of poitiers?
delta tau delta	['wsu', 'tcu', 'purdue', 'penn state', 'ohio state']	what do you want to know about this fraternity?
shell factory	['event', 'jewelry', 'wedding']	what do you want to know about this nature?
mathway calc	['algebra', 'graphing']	which subject are you looking for?
city of westland	['water department', 'assessor', 'building department', 'police department', 'treasurer']	what do you want to know about this acceptance agent?
sandbridge	['rental', 'homes for sale']	what do you want to know about this virginia beach?
fireplace accessories	['gas', 'wood', 'electric', 'propane']	which fuel are you looking for?
dry aged steak	['filet mignon', 'delmonico', 'ribeye', 'strip', 'skirt']	what do you want to know about this flavor?
skip hop	['diaper bag', 'high chair', 'baby', 'bouncer', 'toy']	what do you want to know about this brand?
backyard shed	['office', 'bathroom', 'hot tub', 'gym', 'bedroom']	which space are you looking for?
further education	['for nurse', 'for pharmacist', 'for physician assistant', 'for counselor', 'for optometrist']	what do you want to know about this form?
age demographics	['by zip code', 'us population']	what do you want to know about age demographics?
hazard lights	['tractor', 'car', 'bus']	which vehicle are you looking for?
seagate discwizard	['windows 10', 'windows 7', 'windows 8']	what do you want to know about this software?
vob player	['windows', 'mac', 'android']	which device are you looking for?
wire rack	['shelving', 'wire rack cart']	which product are you looking for?
pestworld	['bed bug', 'ant', 'spider']	which pest control are you looking for?
williston nd	['real estate', 'newspaper', 'elevator', 'salon', 'restaurant']	what do you want to know about williston nd?
causes for gout	['toe', 'elbow', 'finger']	which area are you looking for?
mjd	['tool', 'design', 'photography', 'engineering']	what do you want to know about this disease?
atlanta diabetes associates	['endocrinology diabetes metabolism', 'physician assistant pa', 'provider']	which group are you looking for?
south lake hospital	['radiology', 'medical record', 'pharmacy']	which service are you looking for?
tukui client	['for windows', 'for mac', 'for linux']	what do you want to know about this program?
southern farm bureau	['insurance', 'bank']	which survice are you looking for?
add printer to wifi	['hp', 'canon', 'epson', 'brother', 'lexmark']	which brand are you looking for?
coordination of benefits definition	['business', 'english', 'economics', 'management']	what do you want to know about coordination of benefits definition?
aiseesoft screen recorder	['pc', 'android', 'ios']	which device are you looking for?
bizet	['symphony', 'opera', 'contemporary']	what do you want to know about this composer?
railcard uk	['senior', 'student']	which people are you looking for?
wicker accent tables	['indoor', 'outdoor']	what do you want to know about wicker accent tables?
mo white	['marsh', 'river']	what do you want to know about mo white?
iluvien	['injection', 'cost', 'side effect', 'package insert', 'indication']	which information are you looking for?
design studio	['exterior', 'interior']	what do you want to know about design studio?
converter video	['mp3', 'mp4', 'dvd', 'avi', 'wmv']	which video format are you looking for?
forest products	['northern', 'eastern', 'southern', 'central', 'western']	which region are you looking for?
white duvet cover	['queen', 'king', 'twin', 'full']	which size are you looking for?	3
mental health charities	['national mental health charities', 'local mental health charities']	what do you want to know about mental health charities?
continuous quality improvement	['process', 'tool', 'theory', 'software', 'system']	which product are you looking for?
lipid rescue	['guideline', 'policy']	what do you want to know about this lipid emulsion?
windows 10 cleanup	['upgrade', 'profile']	which information are you looking for?
music unblocked	['rap', 'country', 'classical', 'rock', 'techno']	which genre are you looking for?
tamarillo	['fruit', 'seed']	what do you want to know about this tree tomato?
docker volumes	['windows', 'postgres', 'mysql']	which database are you looking for?
colts reddit	['seahawk', 'steeler', 'texan']	which team are you looking for?
argonne	['credit union', 'insurance', 'dental', 'medical', 'retirement']	which benefit are you looking for?
mustang 2012	['specs', 'manual', 'review']	what do you want to know about this performance?
cotillon	['for party', 'for wedding']	what do you want to know about this music?
duke street	['pediatric dentistry', 'urgent care', 'pediatric', 'family medicine', 'pharmacy']	which service are you looking for?
vertis	['inc bankruptcy', 'aviation', 'retail', 'construction', 'energy']	what do you want to know about this great greek singer?
garfield and friends	['intro', 'character', 'episode', 'dvd', 'vhs']	what do you want to know about garfield and friends?
houma courier	['newspaper', 'sport']	what do you want to know about this exact digital replica?
best place to buy watches	['seiko', 'rolex', 'breitling', 'omega', 'seiko']	which brand are you looking for?
minarik	['guitar', 'bass']	what do you want to know about this speed control?
princeton bc	['weather', 'motel', 'restaurant', 'cabin']	what do you want to know about princeton bc?
short pump town center	['event', 'job', 'zip code']	what do you want to know about this shop?
palm beach docket	['court', 'traffic']	what do you want to know about palm beach docket?
mount whitney	['weather', 'fact', 'hotel']	what do you want to know about this peak?
study to show thyself approved	['nkjv', 'niv', 'nasb', 'esv']	which version are you looking for?
space weather news	['noaa', 'nasa', 'esa']	which agency are you looking for?
seasonique birth control	['dosage', 'coupon', 'package insert']	what do you want to know about this birth control pill?
trio restaurant	['mediterranean', 'italian']	which cuisine are you looking for?
time for change	['quote', 'song']	what do you want to know about time for change?
news jerusalem	['fox', 'cnn', 'abc', 'bbc', 'nbc']	which channel are you looking for?
anglin	['construction', 'civil', 'property', 'family', 'insurance']	which service are you looking for?
clone watches	['breitling', 'omega', 'rolex', 'panerai', 'cartier']	which brand are you looking for?
sony a7r	['review', 'firmware', 'manual', 'specs', 'for sale']	what do you want to know about this full frame?
hits from 1979	['dance', 'pop', 'rock']	which genre are you looking for?
daly city ca	['hotel', 'zip code', 'population']	what do you want to know about daly city ca?
parachute colorado	['weather', 'hotel', 'restaurant', 'zip code']	what do you want to know about parachute colorado?
polar fleece	['sock', 'pant', 'jacket', 'blanket', 'hat']	which clothing are you looking for?
spoiled children	['statistics', 'psychology', 'history']	what do you want to know about spoiled children?
alse	['army', 'air force', 'coast guard']	which service are you looking for?
empire gaming	['chair', 'table']	which office are you looking for?
bright path	['mortgage', 'health insurance', 'refinance']	which loan are you looking for?
two piece swimsuit	['halter', 'strapless', 'one shoulder', 'cap sleeve']	which style are you looking for?
chlamydia	['fact', 'life cycle', 'type']	what do you want to know about this sexually transmitted disease?
venture one credit card	['capital', 'chase']	which annual fee are you looking for?
authentic watch	['rolex', 'cartier', 'fossil', 'gucci']	which brand are you looking for?
rose gold bracelet	['pandora', 'cartier', 'michael kors', 'kate spade', 'givenchy']	what do you want to know about this ring?
yt converter	['mp3', 'mp4']	which audio format are you looking for?
agris	['software', 'system']	which product are you looking for?
hieroglyphics	['for kid', 'animal']	what do you want to know about this form of writing?
recall from outlook	['2010', '2013', '2016']	what do you want to know about recall from outlook?
janie and jack clothing	['kid', 'baby']	who are you shopping for?
squinkies	['spongebob', 'disney', 'star war', 'marvel', 'toy story']	what do you want to know about this kid?
vampire masquerade bloodlines	['patch', 'mods', 'walkthrough', 'review', 'soundtrack']	what do you want to know about vampire masquerade bloodlines?
rogers activity center	['soccer', 'baseball', 'basketball', 'volleyball']	which sport are you looking for?
coin envelope	['white', 'clear', 'yellow', 'red', 'gold']	which necklace are you looking for?
motilal oswal	['financial service', 'asset management', 'private equity']	which service are you looking for?
